+#####++C
##+++++++
++++++#+#
+++++#++#
+##++++##
++++++###
###++++##
######+++
M++++++++