+###++#+C
##++#+#++
++++#+#+#
++++++++#
+##++++##
++++++###
###++++##
######+++
M++++++++